施策カバー	施策検討	表＿施策カバー範囲
表で施策を	施策検討	表＿施策カバー範囲
現状の課題	背景・現状	表＿箇条書き
現状分析課	背景・現状	表＿箇条書き
箇条書きの	背景・現状	表＿箇条書き
表の記載方	背景・現状	表＿箇条書き
背景・事業	背景・現状	表＿箇条書き
課題と施策	課題	表＿矢印
複数からま	課題	表＿矢印
課題と背景	課題	表＿矢印
多軸棒グラ	背景・現状	表＿グラフ
表の書き方	背景・現状	表＿グラフ
2軸分類と	背景・現状	マトリクス
２軸のロー	今後の方針	マトリクス＿方向
棒・補足情	分析	棒グラフ＿補足情報
グラフ細分	分析	棒グラフ＿強調
棒グラフ強	分析	棒グラフ＿強調
棒グラフ比	分析	棒グラフ＿強調
棒グ上昇率	分析	棒グラフ＿強調
棒グラフト	分析	棒グラフ＿トレンド
棒グラフ強	分析	棒グラフ＿トレンド
年度別折れ	分析	折れ線グラフ
折れ線グラ	分析	折れ線グラフ
滝グラフ、	分析	滝グラフ
滝グラフと	分析	滝グラフ
滝グラフ例	分析	滝グラフ
滝グラフ足	分析	滝グラフ
棒折れグラ	分析	棒グラフ×折れ線グラフ
ロジックツ	課題	ロジックツリー（原因の分解）
原因の分解	課題	ロジックツリー（原因の分解）
サプライチ	背景・現状	サプライチェーン
デマンドチ	背景・現状	サプライチェーン
スキーム説	背景・現状	スキーム
イメージロ	今後の方針	ロードマップ
ヒアリング	背景・現状	ヒアリング結果
世界地図を	背景・現状	海外状況
世界地図表	背景・現状	海外状況
海外から日	背景・現状	海外状況
事業分野	背景・現状	事業分野企業ごと
各国の3軸	分析	散布図
技術習得図	施策検討	スキルジャーニー
検討・ステ	施策検討	検討ステップ
検討・結果	施策検討	表＿矢印
概要・背景	背景・現状	表＿箇条書き
背景・概要	背景・現状	表＿矢印
法令・規制	背景・現状	ロードマップ
生産性向上	背景・現状	サイクル